8 8
********
*......*
*......*
*......*
*...#..*
*...#..*
*......*
********
2
3 3 4 3
1 1 1 1 6 6 6 6
10